赛事,参赛人数,金牌,银牌,铜牌,总计,排名
1984年洛杉矶,216,15,8,9,32,4
1988年汉城,273,5,11,12,28,11
1992年巴塞罗那,244,16,22,16,54,4
1996年亚特兰大,294,16,22,12,50,4
2000年悉尼,271,28,16,14,58,3
2004年雅典,384,32,17,14,63,2
2008年北京,639,48,22,30,100,1
2012年伦敦,396,38,31,22,91,2
2016年里约,412,26,18,26,70,3
2020年东京,431,38,32,18,88,2
